F 76,76,76
C 99,99,99

NO textures/cobblestone.xpm
SO textures/cobblestone_01.xpm
WE textures/cobblestone.xpm
EA textures/cobblestone_02.xpm


11111111111111111111111111111
101000001000000000000000000011111
101010101011111110001111100000001
100010100010000010000000000011111
111110101111101011101111111111
100000101000101000001
1011111010111011111011111111111111
1010000010101000001000000000000001
1010111110101111101011111011011101
1010100010101000101011110011011101
1011101010101010101011000111011101
1000001010100010100011011111011101
1111111010111110110110010000000001
1000001010001000100010110111111111
1011101011101011101111110111111111
1010001000001000111111110111111111
10101111111111101100000001111111
10001000000000001000100001
101010111011111000001
1N1000001000000000001
111111111111111111111

