F 119,120,100
C 90,100,200

NO medpart/textures/cobblestone.xpm
SO medpart/textures/cobblestone_01.xpm
WE medpart/textures/cobblestone.xpm
EA medpart/textures/cobblestone_02.xpm


1111111111111111111111111
1000010000000000011000001
1100100010101010010011101
1000000000000000000001111
1000000000000000000000001
1000000E00000011111000001
1000000000000000000000001
1000000000000000000000001
1111111111111111111111111

