F 20,50,50
C 70,100,150

NO parsing_med/textures/wood5e.xpm
SO parsing_med/textures/wood5f.xpm
WE parsing_med/textures/wood5g.xpm
EA parsing_med/textures/wood5h.xpm

111111111111111111111
100010000000000011001
110010001010101001001
100000000000000000001
100000000000000000001
100000000000111110001
100000000000000000001
100000E00000000000001
100000000000111110001
100000000000000000001
100000000000000000001
100000000000111110001
100000000000000000001
100000000000000000001
111111111111111111111