F 100,150,10
C 50,100,200

NO textures/cobblestone.xpm
SO textures/cobblestone_01.xpm
WE textures/cobblestone.xpm
EA textures/cobblestone_02.xpm

111111111111111111111
101000001000000000001
101010101011111110001
100010100010000010001
111110101111101011101
100000101000101000001
101011111010111110101
101010001010100010101
100010000000000010001
101010111011111111101
1N1000001000000000001
111111111111111111111
