F 76,76,76
C 99,99,99

NO textures/cobblestone.xpm
SO textures/cobblestone_01.xpm
WE textures/cobblestone.xpm
EA textures/cobblestone_02.xpm


111111111111111111111111111111
1010000010000000000000000000111111
1010101010111111100011111000000011
1000101000100000100000000000111011
1111101011111010111011111111111011
1000001010001010000011111111111011
1011111010111011111011111111111011
1010000010101000001000000000000001
1010111110101111101011111011011101
1010100010101000101011110011011101
1011101010101010101011000111011101
1000001010100010100011011111011101
1111111010111110110110010000000001
1000001010001000100010110111111101
1011101011101011101111110111111101
1010001000001000111111110111111101
1010111110111110110000000111111101
1000100000000000100010000111111101
1010101110111110000011111111111101
1N10000010000000000000000000000001
1111111111111111111111111111111111

