F 10,100,50
C 50,100,200

NO textures/cobblestone.xpm
SO textures/cobblestone_01.xpm
WE textures/cobblestone.xpm
EA textures/cobblestone_02.xpm

1111111111111111
1010000000000111
1010101010110111
10001010001000001
11111010111110101
11111010111110101
111111111111111111111
